Heelo Codevval | Hello Codeeval
hELLO cODEEVAL | Hello Codeeval
Hello Codeeval | Hello Codeeval
hELLO cODEEVAL | Hello Codeeval
MmoOcQq PLOEDKrrGvRtffnEaKVrACOIjAecF | t GrfeLcAIFjOKRrrKcaDmvVPnOoMCqOQAEfE
UwJsIXQyiDdbWkedHvLiRQaOJzkoBPVK | BvkzWiQJHDoVQbdLOwPyeJKisRaIXdkU
T saPUIpUUyuJicwjzCcHshQAUun | wuiPyQsCcnUhHcApUzUaIu JjsTU
vkBIkGrXHLQmfQPRrHRDyaGTqJpog | IRgfyQqLHrHkpGXJDPrTBGaRkomQv
Jxu dYBivmUyqoyVifVxzpjzSPSxc i U | jPUmJf  BVuvizcxoy SUqpydYSxziiVx
gqjeLeyUMfAsIXZWElFZDX | FyejZLAXeIqXUDEWgZMsfl
zPvSDkgkx gwciH | PgzSikvgxcDH wk
nCKWZSOxRGtbTIwmlwiwVnB LnmoFOZLpfAPqI | xwwKfCnw OnWmFOqnpTBLiAIVZbloItRGSPmZL
QNVqOkyoDtAmJKS R | QNKqVo ykmtADRJOS
nmQsNrAwlBHaOGFWvtygjD | FrBNmOlWHDganAQyvGsjtw
fSvULOIOHOIHTmUAGgTbPOpWprWX | UvWIOIUgrSHXOTpWHmAbOfGpPOTL
rkZkEajYUuALCyUPxXYJwHrydtrrqEz | rYkUAXLyCqUzrtrjEEkHJyrduwZPYax
qQMtfkAprBixFJQWEOEp ZJKheng qTks LuIjLM | njQ OeIkBpgLJhkAuM JEt QTpsfEZxrqFiMKqLW
xUSsEZBwQgklXhGnogLNyOjdFlAizV | XyiksUlGBOQhwdNLglZznSVoxjEgAF
LxxJtBplILYzvqlxOuCOAWH | qILzOxJWxtYxpBAvOLCHllu
YvvGYz | zYGvYv
XofkiQBbGmhCTGGRedjSEhmtjIeMY | QemGRkmGCIBMTijEGdbfXhjShtYeo
xmsDUVg WnTETFeVAnb ErlhOzAI | eVTxVEWlIFsbO AnhEgAUDzrn Tm
jeCaVYXA | aAjYXCeV
GJiIwwV EvehIkJ | iw vJkweIVJhIEG
wCJHrdQgJLvOPJelpMWTbGblvdxMfN | NMHOPwWTgvlbfJeddbQrlpJLvJMGxC
Heelo Codevval | Hello Codeeval
qTxBYvUlWscd | qWTvYUlcdxsB
YwFwpzUmEepHSOFGPAHwcirmraVSs | OiSPHFwacSmzHFsYpprArGEwmewUV
wKccFeF | FFcewcK
WchVrQGeuxIjVTspRUihcAusnoV MMyZrXqh | ucWxjpshyUrMAIVreihcnsuMZVqhQGTRXVo 
IW tNzAHrCJxXWUaOKDfGsYCJRsg | rXUGIftaOCRxHJANsKWD CgJsYzW
z xuSpkQuPQAubmOwcrbEPgLuMSfOT | OM EcTuSQSwOuPQfkPzmrbgAxpLuub
HbNnDxtkRWo | WNnHokbxtDR
lIBwuOcxLyrG | IwxulcyGBrLO
F Mvp | pMvF 
jROBnaT vTnVPtDcWrozo | VvT znWOrDacRnBTtoojP
PbEbrFCAAfTdhuIcAca WFlbBwNYU | bhdcAlIwbrFbYCW NFTufcaBAEAUP
Hello Codeeval | Hello Codeeval
gLpvvfoVBkBykxgPTkiBoMeoEVANvX | XBBkvTLooAxfEVkMypvBegvogPkiVN
xyShtYKqKCzV | SCqKKhtxzYVy
JVLxNaOsiCkq | JaiCNxVLOksq
K ZkrQYBXPFiKyZnvZWMeeBckGTxLyFaUyVCU | GFnVXckaZPyTKBFWkKYByCZvyiLMZe UQreUx
MtYUHmznDXqghPZDeuHbHfHUWvarzdVLqrLHNB | quqfNPXLHDHUevmazHZzLWgtDHMrhrHdbnBYVU